R 1280 720
NO textures/wall_1.xpm
SO textures/wall_2.xpm
WE textures/wall_3.png
EA textures/wall_4.png

S  textures/sprite_1.xpm

F 100, 20,   60
C 48, 179, 194

        1111111111111111111111111
        1100000000110000000111211
        1000000001110000020110001
        10010000000000S0000110001
111111111011000001110000000000001
110000000011000001110111111111111
11110111111111011100000010001
11110111111111011121010010001
11000000110101011100000012001
11002000100000001100000000001
11000000000100001101010010001
110000011101010111112111100111
11110111 1112101 10111010001
11111111 1111111 111111111111